1111111111111111111111111111111111111111111111111111111111111111111111111111111111111111111111111111
1111111111111111111111111111111111111111111111111111111111111111111111111111111111111111111111111111
1111111111111111111111111111111111111111111111111111111111111111111111111111111111111111111111111111
1111111111111111111111111111111111111111111111111111111111111111111111111111111111111111111111111111
1111111111111111111111111111111111111111111111111111111111111111111111111111111111111111111111111111
1111111111111111111111111111111111111111111111111111111111111111111111111111111111111111111111111111
1111111111111111111111111111111111111111111111111111111111111111111111111111111111111111111111111111
1111111111111111111111111111111111111111111111111111111111111111111111111111111111111111111111111111
1111111111111111111111111111111111111111111111111111111111111111111111111111111111111111111111111111
1111111111111111111111111111111111111111111111111111111111111111111111111111111111111111111111111111
1111111111110001111100000000111111100000000000000000000000001111111111111111111111111111111111111111
1111111111110901111000000500011111000000000000111111111111101111111111111111111111111111111111111111
1111111111110001110011000000001111000050010000111111111111110111111111111111111111111111111111111111
1111111111110001110001100000001111000000100011111111111111101111111111111111111111111111111111111111
1111111111110001110000000500001111005000000111111111111111101111111111111111111111111111111111111111
1111111111110001110000000000001111001010001111111111111111101111111111111111111111111111111111111111
1111111111110001110005001100001111000000111111111111111111101111111111111111111111111111111111111111
1111111111110001110000001100001111100001111111111111111111101111111111111111111111111111111111111111
1111111111110001111000000000011111111111111111111100000000001111111111111111111111111111111111111111
1111111111110011111100005000111111111111111000011100000010001111111111111111111111111111111111111111
1111111111110011111111111000111111111111111000011000000010001111111111111111111111111111111111111111
1111111111110011111111111000111111111111101000010000000000001111111111111111111111111111111111111111
1111111111110011111111111000111111111111000000050000500000001111111111111111111111111111111111111111
1111111111110011111111111000111111111110000500010000000100001111111111111111111111111111111111111111
1111111111110000000111111000011111111000110000010000000000001111111111111111111111111111111111111111
1111111111110000000001111100001111110000000000011000010050001111111111111111111111111111111111111111
1111111111110050011001111110000000111000000500011100000000001111111111111111111111111111111111111111
1111111111110000000000111110000000000000000000011100000000001111111111111111111111111111111111111111
1111111111110050000000111110000500000000000000011111111000111111111111111111111111110000011111111111
1111111111110000005000010000000000100000011000000111111000111111111111111111000000000000001111111111
1111111111110000000000000000000000000000011000000111111000111111111111111110000000050000001111111111
1111111111111001100000000001110000000000000005000011100000000001111111111100000000000000001111111111
1111111111111000001000000000000000000000000000000011000050000000111111111100000000000000001111111111
1111111111111110001000000000000050000011000000000011000000000000111111111100000005000900001111111111
1111111111111111111011110000000000000111000000001111000000110000000000000000000000000000001111111111
1111111111111111111111111111000000000000000050000111000110000000111111111100050000000000001111111111
1111111111111111111111111110000000000050000000001111000000000000111111111100000000050000001111111111
1111111111111111111111111111000011100000000000000011000050001000111111111110000000000000001111111111
1111111111111111111111111111100001050000000110000011100000000001111111111111100000000001111111111111
1111111111111111111111111111100000000000000000500111111111111111111111111111111111111111111111111111
1111111111111111111111111111110000005000100000001111111111111111111111111111111111111111111111111111
1111111111111111111111111111111000000000111000001111111111111111111111111111111111111111111111111111
1111111111111111111111111111111111111111111111111111111111111111111111111111111111111111111111111111
1111111111111111111111111111111111111111111111111111111111111111111111111111111111111111111111111111
1111111111111111111111111111111111111111111111111111111111111111111111111111111111111111111111111111
1111111111111111111111111111111111111111111111111111111111111111111111111111111111111111111111111111
1111111111111111111111111111111111111111111111111111111111111111111111111111111111111111111111111111
1111111111111111111111111111111111111111111111111111111111111111111111111111111111111111111111111111
1111111111111111111111111111111111111111111111111111111111111111111111111111111111111111111111111111
1111111111111111111111111111111111111111111111111111111111111111111111111111111111111111111111111111