1111111111111111111111111111111111111111111111111111111111111111111111111111111111111111111111111111
1000111110000000011111110000000000000000000000000111111111111111111111111111111111111111111111111111
1090111100000000001111100000000000011111111111110111111111111111111111111111111111111111111111111111
1000111000000000000111100000000000111111111111110111111111111111111111111111111111111111111111111111
1000111000000000000111100000000001111111111111110111111111111111111111111111111111111111111111111111
1000111000000000000111100000000011111111111111110111111111111111111111111111111111111111111111111111
1000111000000000000111100000000011111111111111110111111111111111111111111111111111111111111111111111
1000111000000110000111100000011111111111111111110111111111111111111111111111111111111111111111111111
1000111000000110000111110000111111111111111111110111111111111111111111111111111111111111111111111111
1000111100000000001111111111111111111110000000000111111111111111111111111111111111111111111111111111
1001111110000000011111111111111100001110000000000111111111111111111111111111111111111111111111111111
1001111111111100011111111111111100001100000000000111111111111111111111111111111111111111111111111111
1001111111111100011111111111110100001000000000000111111111111111111111111111111111111111111111111111
1001111111111100011111111111100000000000000000000111111111111111111111111111111111111111111111111111
1001111111111100011111111111000000001000000000000111111111111111111111000000000000001111111111111111
1000000011111100001111111100011000001000000000000111111111111111111100000000000000000000000001111111
1000000000111110000111111000000000001100000000000111111111111111111000000000000000000000000000111111
1000001100111111000000011100000000001110000000000111111111111111111000000000000000000000000000011111
1000000000011111000000000000000000001110000000000111111111111111111000000000000000000000000000011111
1000000000011111000000000000000000001111111100011111111111111111111000000000000000000000000000011111
1000000000001000000000000000001000000011111100011111111111111111111000000000000000000000000000011111
1000000000000000000000000000001100000011111100011111111111111111111000000000000000000000000000011111
1100000000000000100000000000000000000001100000000000011111111111111000000000000000000000000000011111
1100000100000000000000000000000000000001100000000000011111111111111000000000000000000000000000011111
1111000100000000000000000001100000000001100000000000011111111111111000000000000000000000000000011111
1111111101111000000000000011100000000111100000000000000000000000000000000000000000000000000000011111
1111111111111111000000000000000000000111100000000000011111111111111111000000000000000000000001111111
1111111111111111100000000000000000000011100000000000011111111111111111000000000000000000000011111111
1111111111111111100001110000000000000001100000000000011111111111111111111100000011111111111111111111
1111111111111111110000100000000011000001100000000000011111111111111111111111111111111111111111111111
1111111111111111110000000000000000000011111110111111111111111111111111111111111111111111111111111111
1111111111111111111000000000010000000111100010100111111111111111111111111111111111111111111111111111
1000000000001111111100000000010000000111001110110111111111111111111111111111111111111111111111111111
1011111111100111111111000100010000011111001000110111111111111111111111111111111111111111111111111111
1011111111110011111111110111111101110001001011110111111111111111111111111111111111111111111111111111
1011111111111001111111111111111111110101000000010111111111111111111111111111111111111111111111111111
1011111111111101111111111111111111111101111101010111111111111111111111111111111111111111111111111111
1011111111111101111111111111111111110100000001010111111111111111111111111111111111111111111111111111
1011111111111100111111111111111111100101111101010111111111111111111111111111111111111111111111111111
1011111111111110111111111111111111000101000001010111111111111111111111111111111111111111111111111111
1011111000011110000000000100000000000101101101010111111111111111111111111111111111111111111111111111
1011111000011111111011110101111100000101101101000111111111111111111111111111111111111111111111111111
1011111000011111111011110101111100000101101101111111111111111111111111111111111111111111111111111111
1011111000000111111011110101111101111101101100000111111111111111111111111111111111111111111111111111
1011111111110001110011110101111100000000000111110111111111111111111111111111111111111111111111111111
1000011111111100000111110101100101111101111100010111111111111111111111111111111111111111111111111111
1000011111111111111111110000000100000101000101010111111111111111111111111111111111111111111111111111
1000011111111111111111111111111111111101000101110111111111111111111111111111111111111111111111111111
1000010000000000000000000000000000000000000100000111111111111111111111111111111111111111111111111111
1111111111111111111111111111111111111111111111111111111111111111111111111111111111111111111111111111