11111111111111111111111111111111111111111111111111
10001111100000000111111100000000000000000000000001
10901111000000000011111000000000000111111111111101
10001110000000000001111000000000001111111111111101
10001110000000000001111000000000011110000000000001
10001110000000000001111000000000111100000000000001
10001110000000000001111000000000111000011111111111
10001110000000000001111000000111110000111111111111
10001110000000000001111100001111100001111111111111
10001111000000000011111111111111100001100000000001
10011111100000000111111111111111000011100000000001
10011111111111000111111111111111000011000000000001
10011111111111000111111111111101000010000000000001
10011111111111000111111111111000000000000000000001
10011111111111000111111111110000000010000000000001
10000000111111000011111111000000000010000000000001
10000000001111100001111110000000000011000000000001
10000000001111110000000111000000000011100000000001
10000000000111110000000000000000000011100000000001
10000000000111110000000000000000000011111111000111
10000000000010000000000000000000000000111111000111
10000000000000000000000000000000000000111111000111
11000000000000000000000000000000000000011000000001
11000001000000000000000000000000000000011000000001
11110001000000000000000000000000000000011000000001
11111111011110000000000000000000000001111000000001
11111111111111110000000000000000000001111000000001
11111111111111111000000000000000000000111000000001
11111111111111111000000000000000000000011000000001
11111111111111111100000000000000000000011000000001
11111111111111111100000000000000000000111111101111
11111111111111111110000000000100000001111000101001
10000000000011111111000000000100000001110011101101
10111111111001111111110001000100000111110010001101
10111111111100111111111101111111011100010010111101
10111111111110011111111111111111111101010000000101
10111111111111011111111111111111111111011111010101
10111111111111011111111111111111111101000000010101
10111111111111001111111111111111111001011111010101
10111111111111101111111111111111110001010000010101
10111110000111100000000001000000000001011011010101
10111110000111111110111101011111000001011011010001
10111110000111111110111101011111000001011011011111
10111110000001111110111101011111011111011011000001
10111111111100011100111101011111000000000001111101
10000111111111000001111101011001011111011111000101
10000111111111111111111100000001000001010001010101
10000111111111111111111111111111111111010001011101
10000100000000000000000000000000000000000001000001
11111111111111111111111111111111111111111111111111